00000100000
03231200120
01401243240
03300303210
02124441420
04301000210
04240411340
01301210100
03402212320
01131401100
01431403240
03324244000
03014100430
04043201420
03030223040
01014112120
00433140410
01203442110
02120223340
00000100000
